CÛdigo,Departamento,SecciÛn departamento,T.C. (PDI),T.P. (PDI),Total (PDI),ETC (PDI),Tr. Doc. (PDI),Tr. Inv. (PDI),Tr. Aut. (PDI)
305001,¡LGEBRA,¡LGEBRA ,19,1,20,"19,5",45,87,170
305002,AN¡LISIS MATEM¡TICO,AN¡LISIS MATEM¡TICO ,28,0,28,28,71,120,227
305003,ANATOMÕA PATOL”GICA E HISTORIA DE LA CIENCIA,ANATOMÕA PATOL”GICA ,7,3,10,"9,25",30,42,77
305003,ANATOMÕA PATOL”GICA E HISTORIA DE LA CIENCIA,HISTORIA DE LA CIENCIA ,9,0,9,9,28,49,91
305005,BIOLOGÕA CELULAR,BIOLOGÕA CELULAR ,13,0,13,13,32,50,103
305008,ANATOMÕA Y EMBRIOLOGÕA HUMANA,ANATOMÕA Y EMBRIOLOGÕA HUMANA ,17,1,18,"17,25",34,71,125
305009,CIRUGÕA Y SUS ESPECIALIDADES,CIRUGÕA ,12,24,36,"21,13",16,67,149
305009,CIRUGÕA Y SUS ESPECIALIDADES,OFTALMOLOGÕA ,4,5,9,"5,88",2,17,41
305009,CIRUGÕA Y SUS ESPECIALIDADES,OTORRINOLARINGOLOGÕA ,4,8,12,"7,38",3,21,41
305009,CIRUGÕA Y SUS ESPECIALIDADES,UROLOGÕA ,1,8,9,4,,6,12
305009,CIRUGÕA Y SUS ESPECIALIDADES,TRAUMATOLOGÕA Y ORTOPEDIA ,1,7,8,"3,63",,6,10
305010,CONSTRUCCIONES ARQUITECT”NICAS,COMPOSICI”N ARQUITECT”NICA ,3,3,6,"5,25",5,12,25
305010,CONSTRUCCIONES ARQUITECT”NICAS,CONSTRUCCIONES ARQUITECT”NICAS ,29,23,52,"45,63",5,83,226
305011,DERECHO ADMINISTRATIVO,DERECHO ADMINISTRATIVO ,24,5,29,"27,38",24,58,138
305012,DERECHO CIVIL,DERECHO CIVIL ,30,5,35,"32,75",45,111,215
305013,DERECHO CONSTITUCIONAL,DERECHO CONSTITUCIONAL ,20,1,21,"20,5",33,72,153
305014,DERECHO PROCESAL Y ECLESI¡STICO,DERECHO ECLESI¡STICO DEL ESTADO ,4,0,4,4,1,11,34
305014,DERECHO PROCESAL Y ECLESI¡STICO,DERECHO PROCESAL ,13,2,15,"14,5",9,45,107
305015,DERECHO FINANCIERO Y TRIBUTARIO,DERECHO FINANCIERO Y TRIBUTARIO ,23,1,24,"23,75",36,77,150
305016,DERECHO INTERNACIONAL PRIVADO E HISTORIA DEL DERECHO,DERECHO INTERNACIONAL PRIVADO ,8,0,8,8,16,25,50
305016,DERECHO INTERNACIONAL PRIVADO E HISTORIA DEL DERECHO,HISTORIA DEL DERECHO Y DE LAS INSTITUCIONES ,6,2,8,7,3,13,50
305017,DERECHO MERCANTIL Y DERECHO ROMANO,DERECHO MERCANTIL ,15,3,18,"16,88",13,37,83
305017,DERECHO MERCANTIL Y DERECHO ROMANO,DERECHO ROMANO ,5,2,7,"6,5",,18,37
305018,DIBUJO,DIBUJO ,27,3,30,29,15,75,181
305019,DID¡CTICA DE LAS CIENCIAS EXPERIMENTALES,DID¡CTICA DE LAS CIENCIAS EXPERIMENTALES ,13,3,16,"15,25",11,42,99
305020,DID¡CTICA DE LAS CIENCIAS SOCIALES,DID¡CTICA DE LAS CIENCIAS SOCIALES ,14,4,18,"16,75",6,26,77
305021,"DID¡CTICA DE LA EXPRESI”N MUSICAL, PL¡STICA Y CORPORAL",DID¡CTICA DE LA EXPRESI”N CORPORAL ,14,6,20,"18,38",7,38,105
305021,"DID¡CTICA DE LA EXPRESI”N MUSICAL, PL¡STICA Y CORPORAL",DID¡CTICA DE LA EXPRESI”N MUSICAL ,14,3,17,"15,38",4,29,87
305021,"DID¡CTICA DE LA EXPRESI”N MUSICAL, PL¡STICA Y CORPORAL",DID¡CTICA DE LA EXPRESI”N PL¡STICA ,10,4,14,"12,63",5,38,77
305022,DID¡CTICA DE LA LENGUA Y LA LITERATURA,DID¡CTICA DE LA LENGUA Y LA LITERATURA ,35,7,42,"40,25",12,60,199
305023,DID¡CTICA DE LA MATEM¡TICA,DID¡CTICA DE LA MATEM¡TICA ,23,0,23,23,32,84,190
305024,DID¡CTICA Y ORGANIZACI”N ESCOLAR,DID¡CTICA Y ORGANIZACI”N ESCOLAR ,50,9,59,"55,75",47,107,308
305025,ECONOMÕA APLICADA,ECONOMÕA APLICADA ,36,1,37,"36,75",13,89,232
305026,ECONOMÕA FINANCIERA Y CONTABILIDAD,ECONOMÕA FINANCIERA Y CONTABILIDAD ,39,18,57,"51,75",10,89,245
305027,EDAFOLOGÕA Y QUÕMICA AGRÕCOLA,EDAFOLOGÕA Y QUÕMICA AGRÕCOLA ,11,0,11,11,27,44,83
305030,ESTADÕSTICA E INVESTIGACI”N OPERATIVA,ESTADÕSTICA E INVESTIGACI”N OPERATIVA ,59,3,62,"61,13",88,197,450
305031,ESTRATÕGRAFÕA Y PALEONTOLOGÕA,ESTRATIGRAFÕA ,6,0,6,6,20,28,55
305031,ESTRATÕGRAFÕA Y PALEONTOLOGÕA,PALEONTOLOGÕA ,10,0,10,10,41,51,98
305032,ESTUDIOS SEMÕTICOS,ESTUDIOS ¡RABES E ISL¡MICOS ,18,0,18,18,22,51,114
305032,ESTUDIOS SEMÕTICOS,ESTUDIOS HEBREOS Y ARAMEOS ,8,0,8,8,14,24,45
305033,EXPRESION GR¡FICA ARQUITECT”NICA Y EN LA INGENIERÕA,EXPRESI”N GR¡FICA ARQUITECT”NICA ,23,20,43,"36,25",3,59,168
305033,EXPRESION GR¡FICA ARQUITECT”NICA Y EN LA INGENIERÕA,EXPRESI”N GR¡FICA EN LA INGENIERÕA ,3,4,7,"5,38",2,10,29
305033,EXPRESION GR¡FICA ARQUITECT”NICA Y EN LA INGENIERÕA,"INGENIERÕA CARTOGR¡FICA, GEOD…SICA Y FOTOGRAMETRÕ ",1,3,4,"3,25",,,8
305033,EXPRESION GR¡FICA ARQUITECT”NICA Y EN LA INGENIERÕA,PROYECTOS ARQUITECT”NICOS ,17,11,28,"25,13",4,8,92
305034,FARMACIA Y TECNOLOGÕA FARMAC…UTICA,FARMACIA Y TECNOLOGÕA FARMAC…UTICA ,16,0,16,16,12,56,114
305034,FARMACIA Y TECNOLOGÕA FARMAC…UTICA,"HISTORIA DE LA FARMACIA, LEGISLACI”N Y GESTI”N FARM ",5,0,5,5,,21,49
305035,FARMACOLOGÕA,FARMACOLOGÕA ,23,3,26,"24,13",47,109,198
305036,LENGUA ESPA—OLA,LENGUA ESPA—OLA ,18,0,18,18,31,67,145
305037,FILOLOGÕA FRANCESA,FILOLOGÕA FRANCESA ,20,0,20,20,14,53,132
305038,FILOLOGÕA GRIEGA,FILOLOGÕA ESLAVA ,17,0,17,17,6,14,61
305038,FILOLOGÕA GRIEGA,FILOLOGÕA GRIEGA ,1,0,1,1,0,0,0
305038,FILOLOGÕA GRIEGA,FILOLOGÕA GRIEGA ,10,0,10,10,20,47,91
305039,FILOLOGÕA INGLESA,FILOLOGÕA ALEMANA  ,6,2,8,"7,13",6,11,31
305039,FILOLOGÕA INGLESA,FILOLOGÕA INGLESA,48,2,50,"49,63",42,140,303
305040,FILOLOGÕA LATINA,FILOLOGÕA LATINA ,13,0,13,"12,75",41,64,135
305041,"FILOLOGÕAS ROM¡NICA, ITALIANA, GALLEGO-PORTUGUESA Y CATALANA",FILOLOGÕA CATALANA ,2,0,2,2,2,5,9
305041,"FILOLOGÕAS ROM¡NICA, ITALIANA, GALLEGO-PORTUGUESA Y CATALANA",FILOLOGÕA ITALIANA ,8,0,8,8,6,20,47
305041,"FILOLOGÕAS ROM¡NICA, ITALIANA, GALLEGO-PORTUGUESA Y CATALANA",FILOLOGÕA ROM¡NICA ,4,1,5,"4,25",9,14,37
305041,"FILOLOGÕAS ROM¡NICA, ITALIANA, GALLEGO-PORTUGUESA Y CATALANA",FILOLOGÕAS GALLEGA Y PORTUGUESA ,5,0,5,5,9,12,23
305042,FILOSOFÕA I,EST…TICA Y TEORÕA DE LAS ARTES ,3,0,3,3,,3,9
305042,FILOSOFÕA I,FILOSOFÕA MORAL ,3,1,4,"3,25",6,13,21
305042,FILOSOFÕA I,L”GICA Y FILOSOFÕA DE LA CIENCIA ,9,0,9,9,23,40,68
305043,"FILOSOFÕA DEL DERECHO, MORAL Y POLÕTICA",FILOSOFÕA DEL DERECHO ,9,0,9,9,22,43,82
305044,FÕSICA APLICADA,FÕSICA APLICADA ,41,1,42,"41,75",112,165,288
305045,"FÕSICA AT”MICA, MOLECULAR Y NUCLEAR","FÕSICA AT”MICA, MOLECULAR Y NUCLEAR ",16,0,16,16,60,74,127
305046,FISIOLOGÕA,FISIOLOGÕA ,30,6,36,33,93,137,240
305047,GEODIN¡MICA,GEODIN¡MICA EXTERNA ,9,0,9,9,19,32,72
305047,GEODIN¡MICA,GEODIN¡MICA INTERNA ,12,0,12,12,43,51,89
305048,AN¡LISIS GEOGR¡FICO REGIONAL Y GEOGRAFÕA FÕSICA,AN¡LISIS GEOGR¡FICO REGIONAL ,5,0,5,5,3,19,38
305048,AN¡LISIS GEOGR¡FICO REGIONAL Y GEOGRAFÕA FÕSICA,GEOGRAFÕA FÕSICA ,6,0,6,6,3,20,42
305049,GEOGRAFÕA HUMANA,GEOGRAFÕA HUMANA ,9,2,11,"10,5",10,30,73
305050,GEOMETRÕA Y TOPOLOGÕA,GEOMETRÕA Y TOPOLOGÕA ,24,0,24,24,66,91,173
305051,HISTORIA DEL ARTE,HISTORIA DEL ARTE ,37,0,37,37,75,131,269
305052,HISTORIA CONTEMPOR¡NEA,HISTORIA CONTEMPOR¡NEA ,13,0,13,13,31,53,101
305053,HISTORIA MEDIEVAL Y CIENCIAS Y T…CNICAS HISTORIOGR¡FICAS,CIENCIAS Y T…CNICAS HISTORIOGR¡FICAS ,7,0,7,7,7,31,66
305053,HISTORIA MEDIEVAL Y CIENCIAS Y T…CNICAS HISTORIOGR¡FICAS,HISTORIA MEDIEVAL ,10,0,10,10,22,40,74
305054,HISTORIA MODERNA Y DE AM…RICA,HISTORIA DE AM…RICA ,4,0,4,4,10,20,38
305054,HISTORIA MODERNA Y DE AM…RICA,HISTORIA MODERNA ,9,0,9,9,18,33,66
305055,INGENIERÕA QUÕMICA,INGENIERÕA QUÕMICA ,25,4,29,"27,75",42,62,129
305056,ARQUITECTURA Y TECNOLOGÕA DE COMPUTADORES,ARQUITECTURA Y TECNOLOGÕA DE COMPUTADORES ,30,3,33,"31,13",54,91,174
305056,ARQUITECTURA Y TECNOLOGÕA DE COMPUTADORES,INGENIERÕA DE SISTEMAS Y AUTOM¡TICA ,1,0,1,1,2,6,12
305057,LING‹ÕSTICA GENERAL Y TEORÕA DE LA LITERATURA,LING‹ÕSTICA GENERAL ,10,0,10,10,8,27,63
305057,LING‹ÕSTICA GENERAL Y TEORÕA DE LA LITERATURA,TEORÕA DE LA LITERATURA Y LITERATURA COMPARADA ,12,0,12,"11,75",24,52,102
305058,MATEM¡TICA APLICADA,MATEM¡TICA APLICADA ,49,0,49,49,85,168,342
305059,MEDICINA,DERMATOLOGÕA ,6,4,10,"7,5",10,34,70
305059,MEDICINA,MEDICINA ,20,56,76,"41,38",47,97,219
305061,MICROBIOLOGÕA,MICROBIOLOGÕA ,37,1,38,"37,38",118,169,298
305062,MINERALOGÕA Y PETROLOGÕA,CRISTALOGRAFÕA Y MINERALOGÕA ,16,0,16,16,59,78,140
305062,MINERALOGÕA Y PETROLOGÕA,PETROLOGÕA Y GEOQUÕMICA ,8,0,8,8,23,32,59
305063,NUTRICI”N Y BROMATOLOGÕA,NUTRICI”N Y BROMATOLOGÕA ,19,0,19,19,45,83,154
305064,OBSTETRICIA Y GINECOLOGÕA,OBSTETRICIA Y GINECOLOGÕA ,5,14,19,"12,13",4,17,37
305065,PARASITOLOGÕA,PARASITOLOGÕA ,15,0,15,15,42,76,150
305066,PEDAGOGÕA,TEORÕA E HISTORIA DE LA EDUCACI”N ,27,4,31,"29,5",26,62,178
305067,"PERSONALIDAD, EVALUACI”N Y TRATAMIENTO PSICOL”GICO","PERSONALIDAD, EVALUACI”N Y TRATAMIENTO PSICOL”GIC ",38,1,39,"38,75",76,110,239
305068,PREHISTORIA Y ARQUEOLOGÕA,ARQUEOLOGÕA ,5,0,5,5,12,16,37
305068,PREHISTORIA Y ARQUEOLOGÕA,PREHISTORIA ,17,0,17,17,44,71,143
305069,PSICOLOGÕA EVOLUTIVA Y DE LA EDUCACI”N,PSICOLOGÕA EVOLUTIVA Y DE LA EDUCACI”N ,49,6,55,"52,75",29,96,303
305070,PSICOLOGÕA EXPERIMENTAL,PSICOLOGÕA EXPERIMENTAL ,2,0,2,2,0,0,0
305070,PSICOLOGÕA EXPERIMENTAL,PSICOLOGÕA EXPERIMENTAL ,31,0,31,31,67,94,177
305071,QUÕMICA ANALÕTICA,QUÕMICA ANALÕTICA ,29,0,29,29,70,117,218
305072,QUÕMICA FÕSICA,QUÕMICA FÕSICA ,19,0,19,19,52,82,145
305073,QUÕMICA INORG¡NICA,QUÕMICA INORG¡NICA ,33,0,33,33,95,148,266
305074,QUÕMICA ORG¡NICA,QUÕMICA ORG¡NICA ,19,0,19,19,59,81,154
305075,RADIOLOGÕA Y MEDICINA FÕSICA,RADIOLOGÕA Y MEDICINA FÕSICA ,9,13,22,"14,63",19,43,82
305076,SOCIOLOGÕA,SOCIOLOGÕA ,37,10,47,"43,5",21,95,214
305077,CIENCIAS DE LA COMPUTACI”N E INTELIGENCIA ARTIFICIAL,CIENCIAS DE LA COMPUTACI”N E INTELIGENCIA ARTIFICIAL ,66,3,69,"68,25",146,201,405
305078,DERECHO PENAL,DERECHO PENAL ,20,1,21,"20,38",39,68,131
305079,LENGUAJES Y SISTEMAS INFORM¡TICOS,LENGUAJES Y SISTEMAS INFORM¡TICOS ,50,3,53,"51,75",34,121,338
305080,FÕSICA TE”RICA Y DEL COSMOS,ASTRONOMÕA Y ASTROFÕSICA ,10,0,10,10,24,33,47
305080,FÕSICA TE”RICA Y DEL COSMOS,FÕSICA DE LA TIERRA ,7,0,7,7,20,34,58
305080,FÕSICA TE”RICA Y DEL COSMOS,FÕSICA TE”RICA ,15,0,15,15,43,54,76
305081,INFORMACI”N Y DOCUMENTACI”N,BIBLIOTECONOMÕA Y DOCUMENTACI”N ,27,1,28,"27,75",42,109,221
305081,INFORMACI”N Y DOCUMENTACI”N,COMUNICACI”N AUDIOVISUAL Y PUBLICIDAD ,3,7,10,7,2,3,10
305082,PINTURA,PINTURA ,33,0,33,33,29,98,222
305083,ESCULTURA,ESCULTURA ,24,1,25,"24,38",6,42,129
305084,ELECTROMAGNETISMO Y FÕSICA DE LA MATERIA,ELECTROMAGNETISMO ,8,0,8,8,18,30,57
305084,ELECTROMAGNETISMO Y FÕSICA DE LA MATERIA,FÕSICA DE LA MATERIA CONDENSADA ,7,0,7,7,22,28,45
305085,EDUCACI”N FÕSICA Y DEPORTIVA,EDUCACI”N FÕSICA Y DEPORTIVA ,53,7,60,"57,25",32,103,304
305086,CIENCIA POLÕTICA Y DE LA ADMINISTRACI”N,CIENCIA POLÕTICA Y DE LA ADMINISTRACI”N ,27,6,33,"31,13",25,65,144
305087,DERECHO INTERNACIONAL P⁄BLICO Y RELACIONES INTERNACIONALES,DERECHO INTERNACIONAL P⁄BLICO Y RELACIONES INTERN ,15,0,15,15,22,44,93
305088,DERECHO DEL TRABAJO,DERECHO DEL TRABAJO Y DE LA SEGURIDAD SOCIAL ,26,7,33,"30,5",29,73,164
305089,GEN…TICA,GEN…TICA ,18,1,19,"18,75",44,58,108
305090,HISTORIA ANTIGUA,HISTORIA ANTIGUA ,11,0,11,11,32,60,116
305091,PEDIATRÕA,PEDIATRÕA ,7,11,18,"11,13",19,38,76
305092,INGENÕERIA CIVIL,INGENIERÕA DEL TERRENO ,7,4,11,"9,5",9,18,53
305092,INGENÕERIA CIVIL,INGENIERÕA E INFRAESTRUCTURA DE LOS TRANSPORTES ,2,6,8,"5,5",2,3,9
305092,INGENÕERIA CIVIL,INGENIERÕA EL…CTRICA ,6,3,9,"7,5",4,7,24
305092,INGENÕERIA CIVIL,TECNOLOGÕAS DEL MEDIO AMBIENTE ,9,2,11,"10,13",15,28,49
305093,”PTICA,”PTICA ,33,2,35,"34,5",52,95,193
305094,MEDICINA PREVENTIVA Y SALUD P⁄BLICA,MEDICINA PREVENTIVA Y SALUD P⁄BLICA ,14,5,19,"15,88",27,58,117
305095,TRADUCCI”N E INTERPRETACI”N,TRADUCCI”N E INTERPRETACI”N ,56,1,57,"56,75",34,120,323
305096,ESTOMATOLOGÕA,ESTOMATOLOGÕA ,45,29,74,"65,88",46,174,370
305098,PSICOLOGÕA SOCIAL Y METODOLOGÕA DE LAS CIENCIAS DEL COMPORTAMIENTO,PSICOLOGÕA SOCIAL ,24,6,30,"27,63",13,45,123
305099,ORGANIZACI”N DE EMPRESAS,ORGANIZACI”N DE EMPRESAS ,43,8,51,"48,63",27,51,163
305100,MEC¡NICA DE MEDIOS CONTINUOS Y TEORÕA DE ESTRUCTURAS,INGENIERÕA HIDR¡ULICA ,9,2,11,"10,5",12,15,46
305100,MEC¡NICA DE MEDIOS CONTINUOS Y TEORÕA DE ESTRUCTURAS,MEC¡NICA DE MEDIOS CONTINUOS Y TEORÕA DE ESTRUCTU ,17,8,25,"22,5",11,28,84
305101,M…TODOS DE INVESTIGACI”N Y DIAGN”STICO EN EDUCACI”N,M…TODOS DE INVESTIGACI”N Y DIAGN”STICO EN EDUCACI ,24,1,25,"24,75",19,41,144
305102,M…TODOS CUANTITATIVOS PARA LA ECONOMÕA Y LA EMPRESA,M…TODOS CUANTITATIVOS PARA LA ECONOMÕA Y LA EMPRE ,20,1,21,"20,75",17,52,127
305103,LITERATURA ESPA—OLA,LITERATURA ESPA—OLA ,16,0,16,"15,75",33,59,123
305104,QUÕMICA FARMAC…UTICA Y ORG¡NICA,QUÕMICA FARMACE⁄TICA Y ORG¡NICA ,1,0,1,1,0,0,0
305104,QUÕMICA FARMAC…UTICA Y ORG¡NICA,QUÕMICA FARMACE⁄TICA Y ORG¡NICA ,16,1,17,"16,38",36,56,85
305105,COMERCIALIZACI”N E INVESTIGACI”N DE MERCADOS,COMERCIALIZACI”N E INVESTIGACI”N DE MERCADOS ,24,4,28,"26,75",11,30,98
305106,BOT¡NICA,BOT¡NICA ,16,3,19,18,41,68,127
305107,FISIOLOGÕA VEGETAL,FISIOLOGÕA VEGETAL ,16,0,16,16,45,71,135
305108,HISTOLOGÕA,HISTOLOGÕA ,9,2,11,"9,88",26,35,69
305109,TEORÕA E HISTORIA ECON”MICA,FUNDAMENTOS DEL AN¡LISIS ECON”MICO ,16,0,16,16,15,29,61
305109,TEORÕA E HISTORIA ECON”MICA,HISTORIA E INSTITUCIONES ECON”MICAS ,8,1,9,"8,5",10,28,51
305110,ANTROPOLOGÕA SOCIAL,ANTROPOLOGÕA SOCIAL ,16,2,18,"17,25",26,41,82
305111,TRABAJO SOCIAL Y SERVICIOS SOCIALES,TRABAJO SOCIAL Y SERVICIOS SOCIALES ,14,6,20,"16,25",3,41,99
305112,FISIOTERAPIA,FISIOTERAPIA ,12,29,41,"24,63",2,16,65
305113,ENFERMERÕA,ENFERMERÕA ,39,74,113,"76,63",10,99,296
305114,"TEORÕA DE LA SE—AL, TELEM¡TICA Y COMUNICACIONES",INGENIERÕA TELEM¡TICA ,10,2,12,"11,25",12,15,47
305114,"TEORÕA DE LA SE—AL, TELEM¡TICA Y COMUNICACIONES",TEORÕA DE LA SE—AL Y COMUNICACIONES ,13,1,14,"13,38",26,38,72
305115,ELECTR”NICA Y TECNOLOGÕA DE COMPUTADORES,ELECTR”NICA ,20,1,21,"20,75",33,48,93
305115,ELECTR”NICA Y TECNOLOGÕA DE COMPUTADORES,TECNOLOGÕA ELECTR”NICA ,6,2,8,"6,75",12,16,31
305116,ECOLOGÕA,ECOLOGÕA ,14,0,14,14,37,51,82
305117,ZOOLOGÕA,ZOOLOGÕA ,1,0,1,1,0,0,0
305117,ZOOLOGÕA,ZOOLOGÕA ,24,1,25,"24,63",61,116,197
305118,BIOQUÕMICA Y BIOLOGÕA MOLECULAR I ,BIOQUÕMICA Y BIOLOGÕA MOLECULAR I ,1,0,1,1,0,0,0
305118,BIOQUÕMICA Y BIOLOGÕA MOLECULAR I ,BIOQUÕMICA Y BIOLOGÕA MOLECULAR I ,17,0,17,17,28,56,122
305119,BIOQUÕMICA Y BIOLOGÕA MOLECULAR II ,BIOQUÕMICA Y BIOLOGÕA MOLECULAR II ,19,1,20,"19,5",58,88,156
305120,BIOQUÕMICA Y BIOLOGÕA MOLECULAR 3 E INMUNOLOGÕA,INMUNOLOGÕA ,6,2,8,"6,75",23,23,42
305120,BIOQUÕMICA Y BIOLOGÕA MOLECULAR 3 E INMUNOLOGÕA,BIOQUÕMICA Y BIOLOGÕA MOLECULAR III ,9,1,10,"9,5",17,35,69
305121,ECONOMÕA INTERNACIONAL Y DE ESPA—A,ECONOMÕA INTERNACIONAL Y DE ESPA—A ,21,3,24,"22,5",11,50,121
305122,FILOSOFÕA II,FILOSOFÕA ,14,0,14,14,27,47,114
305123,FISICOQUIMICA,FÕSICO QUÕMICA ,15,0,15,15,18,73,133
305124,INGENIERIA DE LA CONSTRUCCION Y PROYECTOS DE INGENIERIA,INGENIERÕA DE LA CONSTRUCCI”N ,5,4,9,"7,5",2,15,31
305124,INGENIERIA DE LA CONSTRUCCION Y PROYECTOS DE INGENIERIA,PROYECTOS DE INGENIERÕA ,5,8,13,"9,88",5,8,20
305125,URBANISTICA Y ORDENACION DEL TERRITORIO,URBANÕSTICA Y ORDENACI”N DEL TERRITORIO ,13,4,17,"15,75",2,13,49
305126,METODOLOGIA DE LAS CIENCIAS DEL COMPORTAMIENTO,METODOLOGÕA DE LAS CIENCIAS DEL COMPORTAMIENTO ,12,1,13,"12,5",21,36,81
305127,HISTORIA Y CIENCIAS DE LA M⁄SICA,HISTORIA Y CIENCIAS DE LA M⁄SICA ,12,1,13,"12,75",17,33,79
305128,PSICOBIOLOGIA,PSICOBIOLOGÕA ,12,0,12,12,30,42,91
305129,PSIQUIATRIA,PSIQUIATRÕA ,9,6,15,"11,25",10,26,62
305130,"MEDICINA LEGAL, TOXICOLOGIA Y ANTROPOLOGIA FISICA",ANTROPOLOGÕA FÕSICA ,5,0,5,5,8,19,37
305130,"MEDICINA LEGAL, TOXICOLOGIA Y ANTROPOLOGIA FISICA",MEDICINA LEGAL Y FORENSE ,6,1,7,6,22,29,60
305130,"MEDICINA LEGAL, TOXICOLOGIA Y ANTROPOLOGIA FISICA",TOXICOLOGÕA ,5,0,5,5,14,18,34
